EA ./img/floor.xpm
 SO ./img/wall_02.xpm
NO   ./img/wall.xpm

WE ./img/wall_03.xpm
  
 C 0,0,0


 
F 255,255,255
	11111 
          1
          1
        11111111 1111111111111111
        1000000110110000000000001
        1011000001110000000000001
        1001000000000010000000001
111111111011000001110000000000001
100000000011000001110111111111111
11110111111111011100000010001111111
11110111110000000000010010001   
11000000110101011100000010001
10010100000000001100000010001
1001N10000000001101010010001   
11010100000000000000111000111
11110111111101011101111010001
11111111 1111111 111111111111

  
