
  EA ./img/2.png

 SO ./img/3.png
NO   ./img/1.png

WE 			./img/4.png

 	 C 210,210,210

 
F 255,255,255

	11
	1
    1111111111111111111
    10010010010010010011
    10010010010010010011
11110010010010010011
1001001001001001001111111111
1000000000000000000000000001
100000000N000000000111111111
10000000000000000001
11111111000111111111
10000000000000000001
10000010000000000011
100000111111100000001
1000001     111111111
10000011    100000001
11111111    111111111

 
