EA ./img/floor.xpm
 SO ./img/wall_02.xpm
NO   ./img/wall.xpm

WE ./img/wall_03.xpm
  
 C 0,0,0


 
F 255,255,255
11111111111
10000100001
10000100001
10000100001
11100000001
10000N00001
10000000001
10000000001
10100011111
10110000001
11111111111
